┌───────┬─┐ 
├─────┐ │ │ 
├───╴ │ │ │ 
│ ╶───┤ ╵ │ 
│ ╶─┐ └─╴ │ 
└───┴─────┘ 
