┌─┬─┬─────┬─────┐ 
│ │ ╵ ╶─┐ │ ╷ ╶─┤ 
│ └─────┤ ╵ └─┐ │ 
├─────┐ └─┬───┘ │ 
├───╴ └─┐ │ ┌───┤ 
│ ┌───╴ │ │ ╵ ╷ │ 
│ └─────┤ └─┐ │ │ 
│ ╶───┐ └─╴ └─┘ │ 
└─────┴─────────┘ 
