┌───────┬─────┬───────────────────┬─┐ 
├─────┐ └─╴ ╷ ├─────┐ ┌─────╴ ┌─┐ │ │ 
│ ┌─╴ ├─────┤ │ ┌─┐ └─┘ ┌─────┘ │ │ │ 
│ └─┐ │ ╷ ╷ │ │ │ ├─────┴─┐ ┌───┘ │ │ 
│ ╷ │ └─┘ │ │ ╵ │ ╵ ╶─┐ ╷ ╵ │ ┌───┘ │ 
│ │ └─┬───┤ └─┬─┘ ┌─┬─┘ ├───┘ │ ╶───┤ 
│ └─┐ └─┐ └─╴ │ ╶─┘ │ ╷ │ ┌───┤ ╶─┐ │ 
├─╴ ├─┐ │ ╶───┴─────┘ │ │ └─┐ ╵ ┌─┘ │ 
│ ╶─┤ │ └─────┬─────┐ ├─┴─╴ ├───┘ ╷ │ 
├─┐ ╵ └─┬───┐ ╵ ╶─┐ └─┤ ╶─┬─┘ ╶───┤ │ 
│ └───┐ └─╴ ├─────┴─╴ ├─┐ │ ╶───┐ │ │ 
├───┐ └─╴ ┌─┘ ╷ ┌───┐ ╵ │ └─┬─╴ │ └─┤ 
│ ╷ └─────┘ ┌─┤ │ ╷ └───┴─╴ │ ╶─┴─┐ │ 
│ ├─╴ ┌───┬─┘ ╵ │ ├─────────┘ ┌───┘ │ 
│ └───┘ ╷ │ ┌───┤ │ ┌─────┐ ┌─┤ ┌─╴ │ 
│ ┌─────┘ │ │ ╷ │ └─┤ ┌─╴ │ ╵ │ └───┤ 
│ │ ╶───┬─┴─┘ │ └─┐ │ └─┐ └───┼───╴ │ 
│ └───┐ ╵ ╶───┴─┐ ╵ └─╴ ├───╴ ╵ ┌─╴ │ 
└─────┴─────────┴───────┴───────┴───┘ 
